########
#A #   #
# ### ##
#   #  #
### #B##
#      #
########